Team,Wins,Last final won,Runners-up,Last final lost,Total final appearances
Antrim,6,1979,10,1973,16
Cork,28,2018,22,2022,50
Derry,0,-,1,1954,1
Down,0,-,1,1948,1
Dublin,26,1984,10,1986,36
Galway,4,2021,16,2020,20
Kilkenny,15,2022,11,2019,26
Limerick,0,-,1,1980,1
Louth,0,-,2,1936,2
Mayo,0,-,1,1959,1
Tipperary,5,2004,10,2006,15
Waterford,0,-,1,1945,1
Wexford,7,2012,5,1994,12
